{
    "region": "隐藏",
    "name": "1层",
    "width": 11,
    "height": 11,
    "bgm": "bgm.mp3",
    "bgs": "",
    "layers": {
        "basic": {
            "tiles": [
                [0, 0, 0, 0, 0, 0, 0, 0, 0, 0, 0],
                [0, 1, 1, 1, 1, 1, 1, 1, 1, 1, 0],
                [0, 1, 1, 1, 1, 1, 1, 1, 1, 1, 0],
                [0, 1, 1, 1, 0, 0, 0, 1, 1, 1, 0],
                [0, 1, 1, 1, 0, 0, 0, 1, 1, 1, 0],
                [0, 1, 1, 1, 0, 0, 0, 1, 1, 1, 0],
                [0, 1, 1, 1, 1, 1, 1, 1, 1, 1, 0],
                [0, 1, 1, 1, 1, 1, 1, 1, 1, 1, 0],
                [0, 1, 1, 1, 1, 1, 1, 1, 1, 1, 0],
                [0, 1, 1, 1, 1, 1, 1, 1, 1, 1, 0],
                [0, 0, 0, 0, 0, 0, 0, 0, 0, 0, 0]
            ],
            "events": {
                
            }
        }
    }
}